{
  "h1": "10",
  "h2": "20",
  "h3": "30",
  "h4": "40",
  "h5": "50",
  "h6": "60"
}